NO ./img_cub/north.xpm
SO ./img_cub/south.xpm
WE ./img_cub/west.xpm
EA ./img_cub/east.xpm

F 116,144,159
C 202,220,232

       1111111111111111111111111111111111111111111111111111111111111111111111111111111111111111
       1000000000000000000000100000000000000000000000000000000000000000000000000000000000000011
       1000000000000000000000300000000000000000000000000000000000000000000000000000000000000011
       10000000E0000000000000100000000000000000000000000000000000000000000000000000000000000011
       10010001200000000000003010000000000000000000000000000000000000000000000000000000000000021
11111111010000000000000000000100000000000000000000000000000000000000000000000000000000000000011
10000000010000011111111111111111111111111111111111111111111111111111111111111111111111111111111
11110110111101110001
11000111010101111001
111101 1110101 10001
111111 1111111 11111