NO ./img_cub/north.xpm
SO ./img_cub/south.xpm
WE ./img_cub/west.xpm
EA ./img_cub/east.xpm

F 116,144,159
C 202,220,232

       111111111111111111111111111111111111111
       100000000000000000000000000000000000001
       1001000120000000000000000000000000000W1
1111111101000001000000000000000000000000000011
1000000001000001111111111111111111111111111111
11110110111101110001
11000111010101111001
111101 1110101 10001
111111 1111111 11111