NO ./img_cub/north.xpm
SO ./img_cub/south.xpm
WE ./img_cub/west.xpm
EA ./img_cub/east.xpm

F 116,144,159
C 202,220,232

       11111111111111111
       1E200000000000001
       10010000020000001
111111110100000100000011
100000000100000131111111
11110110111101110001
11000111010101111001
111101 1110101 10001
111111 1111111 11111