NO ./img_cub/north.xpm
SO ./img_cub/south.xpm
WE ./img_cub/west.xpm
EA ./img_cub/east.xpm

F 116,144,159
C 202,220,232

11111111111111111111
1000E000010000002001
10000000030010000001
10000000012000000001
10000000011011111311
10000000000000000001
11113111131111111311
10000000000000200001
10020000000000000001
10000001101000000001
10010000000000100001
10000000000001113111
10000000000001000001
11111111111111111111