NO ./img_cub/wall_1.xpm
SO ./img_cub/wall_2.xpm
WE ./img_cub/wall_3.xpm
EA ./img_cub/wall_4.xpm

F 220,100,0
C 225,30,0

        11111111111111111111111111
        10000010001100000000000001
        10000100011100001000000001
        11010000000000010000000001
1111111110110000011100000000000001
100000000011000011101111111111111
11110111101111E01000000010001
1111011110111101 101010010001
11000000100101001000000010001
10010001000000001100000010001
10000000000000001101010010001
11000101110101011111011110001
11110111 1110101 101111010001
11111111 1111111 111111111111
