NO ./img_cub/black.xpm
SO ./img_cub/white.xpm
WE ./img_cub/yellow.xpm
EA ./img_cub/blue.xpm

F 220,100,0
C 225,30,0

1111111
1E00001
1111111