NO ./../img_cub/black.xpm
SO ./../img_cub/white.xpm
WE ./../img_cub/blue.xpm
EA ./path_to_the_east_texture

F 220,100,0
C 225,30,0

1111111111111111111111111111111111
1000000000000000001100000000000001
1011000001110000000000000000000001
1001000000000000000000000000000001
1100000010110000011100000000000001
1000000000110000011101111111111101
1111000000000100N00000001000000001
1111000000000000010111010100100001
1100000011010101110000001000000001
1000000000000000001000000100000001
1000000000000000000101001000000001
1100000111010100000000000000001101
1111011100000100010111101000000001
1111111111111111111111111111111111
