NO ./img_cub/north.xpm
SO ./img_cub/south.xpm
WE ./img_cub/west.xpm
EA ./img_cub/east.xpm

F 116,144,159
C 202,220,232

11111111111111111111111111111111111111111111111111111111111111111111111
10000000000000000000000000000000000000000000000000000000000000000000001
10000000011111111111100000000001111111111110000000000000000000000000001
10000000000000000001100000000000000000000011000000000000000000000000001
10000000N00000000011000000000000000000000110000000000000000000000000001
10000000000000000110000000000000000000001100000000000000000000000000001
10000000000000001100000000220000000000011000000000000000000000000000001
10000000000000011000000000000000000000110000000000000000000000000000001
10000000000000110000000000110000000001100000000011111131111110000000001
10000000000001100000000000110000000011000000000011000000000110000000001
10000000000011000000000000110000000110000000000011000000000110000000001
10000000000110000000000000110000001100000000000011000000000110000000001
10000000001100000000000000110000011000000000000011000000000110000000001
10000000011000000000000000110000110000000000000011000000000110000000001
10000000011111111111100000110000111111111111000011111113111110000000001
10000000000000000000000000000000000000000000000000000000000000000000001
11111111111111111111111111111111111111111111111111111111111111111111111